#######################################################
#         #         #             #         #         #
#         #         #             #         #         #
#    #         #    #    #   #    #    #         #    #
#    #         #    #    #   #    #    #         #    #
#    #    ######    #    #   #    #    ######    #    #
#    #                   #   #                   #    #
#    #         #    ###############    #         #    #
#    #    #    #                       #    #    #    #
#         #       ##   # ##### #   ##       #         #
#         #       ##   #  ###  #   ##       #         #
#    ######    #####   #########   ######   ######    #
#         #       ##   ###   ###   ##       #         #
#         #       ##   ### # ###   ##       #         #
#    #    #    #                       #    #    #    #
#    #         #    ###############    #         #    #
#    #                   #   #                   #    #
#    #    ######    #    #   #    #    ######    #    #
#    #         #    #    #   #    #    #         #    #
#    #         #    #    #   #    #    #         #    #
#         #         #             #         #         #
#         #         #             #         #         #
#######################################################